WTXTTTZTTT
TTTTXTXTTT
TTTXTTT2TT
TTTTTTTTTT
TTTTTTT1TT
TTTTZTTTTT
TXTTTTTTTT
