WTXTTTZTTT
TTTTXTXTTT
TTTXTTTTTT
TTTTTTTTTT
TTTTTTTTTT
TTTTTTTTTT
TXTTTTTTT1
