WTXTTTZTTT
TTTTXTXT2T
TTTXTTTTTT
TTTTTTTZTT
TT2TTTTT2T
2TTXTTTTTT
TXTTTT2TTT
