WTXTTTZTTT
TTTTXTXTTT
TTTXTTTTTT
TTTTTTTZTT
TT2TTTTTTT
TTTXTTTTTT
2XTTTTTTTT
