WTXTTTZTTTTHHH
DTTTXTXTTTTTHH
SDTXTTPPPTXTHH
SSDTTPPF3TTTTH
SSSDTPPFPZTTTT
SSSSDTPFPTT1TT
SSSSSDTFP2TTTT
